20 20
500 500
6 6 6 6 6 6 6 6 6 6 6 6 6 6 6 6 6 6 6 6
6 0 8 0 8 0 8 0 8 0 8 0 8 0 8 0 8 0 8 6
6 0 1 0 0 1 0 0 1 0 0 1 0 0 7 0 0 7 0 6
6 0 0 0 0 0 0 0 0 0 0 0 0 0 0 0 1 0 0 6
6 0 0 0 0 0 0 0 5 0 0 0 0 0 0 7 0 0 0 6
6 0 0 0 0 0 0 0 0 0 0 0 0 0 7 0 0 0 0 6
6 0 0 7 0 0 0 0 0 0 0 0 0 0 0 7 0 0 0 6
6 0 0 7 0 0 0 0 8 0 0 0 0 0 0 0 7 0 0 6
6 0 0 0 0 0 0 2 0 2 0 0 0 0 0 0 0 7 0 6
6 0 0 0 0 0 0 7 7 7 0 0 0 0 0 0 7 0 0 6
6 0 0 2 0 0 0 0 7 0 0 0 0 0 0 7 0 0 0 6
6 0 0 0 0 0 0 0 7 0 0 0 0 0 7 0 1 0 0 6
6 0 0 0 0 0 0 0 5 0 7 0 0 0 0 7 0 0 0 6
6 0 0 0 0 0 0 0 0 7 7 0 0 0 0 0 7 0 0 6
6 0 0 0 0 0 0 0 0 0 0 0 0 0 0 0 0 7 0 6
6 0 0 8 0 8 0 8 0 8 0 8 0 8 0 8 7 0 0 6
6 0 0 0 0 0 0 0 0 0 0 0 0 0 0 7 0 0 0 6
6 0 0 0 5 0 0 0 0 0 0 0 0 0 7 0 0 0 0 6
6 0 0 0 0 0 0 0 7 7 0 0 0 7 0 0 0 0 0 6
6 6 6 6 6 6 6 6 6 6 6 6 6 6 6 6 6 6 6 6
